- A -
AC: Actual Cost
AD: Accepted Deliverbles
ADM: Arrow Diagramming Method
ADR: Alternative Dispute Resolution
AOA: Activity-On-Arrow
AON: Activity-On-Node
APAC: Asia Pacific Activities Conference
APB: Applied Business Project
ARR: Annual Recurring Revenue

- B -
BA: Business Analytics 
BCA:
BAC: Budget At Completion 
BMT: Benchmarking Test

- C -
CAC: Customer Acquisition Cost
CAPEX: CAPital Expenditures
CBA: Cost-Benefit Analysis
CCB: Change Control Board
CDF: Cumulative Distribution Function
CDM: Conditional Diagramming Method
CJM: Customer Journey Map
CL: Central Line
CLTV: Customer LifeTime Value
CMMI: Capability Maturity Model Integration
CMS: Configuration Management System
CP: Critical Path
CPAF: Cost Plus Award Fee Contracts
CPI: Cost Performance Index
CPIF: Cost Plus Incentive Fee Contracts
CPFF: Cost Plus Fixed Fee
CPM: Critical Path Method
CPPC: Cost Plus Percentage of Cost
CQQ: Cost Of Quality 
CR: Cost Reimbursable
CR: Change Request
CR: Churn Rate
CRR: Customer Retention Rate
CSAT: Customer Satisfaction Score
CSI: Customer Satisfaction Index
CV: Cost Variation(Variance)

- D -
DAU: Daily Active User
DEA: Deterministic Economic Analysis
DfA: Design for Assembly 
DfC: Design for Cost
DFD: Data Flow Diagram
DfL: Design for Logistics
DfM: Design for Manufacturing
DfM: Design for Maintainability
DfS: Design for Serviceability
DfR: Design for Reliability
DFSS: Design for Six Sigma
DfX: Design For Excellence
DIDOV: Define-Identify-Design-Optimize-Verify
DMAIC: Define-Measure-Analyze-Improve-Control
DMADV: Define-Measure-Analyze-Design-Verfify
DRI: Directly Responsible Individual

- E -
EAC:
EDA:  Exploratory Data Analysis
EEF(s): Enterprise Environment Factors
EF: Early Finish Date
EMEA: Europe, Middle East Asia
ERD: Entity Relationship Diagram
EQ: Emotional Intelligence
ERG: Existence, Related, Growth
ES: Early Start Date
ESG: Environmenta), Social, Governance
ETC: Estimate To Complete
EV: Earned Value
EVM: Earned Value Management

- F -
FDD: Feature-Driven Development
FFP: Firm-Fixed-Price Contract
FM: Function Manager
FMEA: Failure Mode and Effect Analysis
FP: Fixed Price 
FP-EPA: Fixed Price with Economic Price Adjustment
FPIF: Fixed Price Incentive Fee


- G -
GD&T : Geometric Dimensioning & Tolerancing
GERT: Graphical Evaluation and Review Technique

- H -

- I -
IFB: Invitation for Bid
IRR: Internal Rate of Return
ITTO: Inputs, Tools, Techniques, Outputs

- J -
JAD: Joint Application Development
JIT: Just-In-Time

- K -
KMS: Knowledge Management System

- L -
LCL: Lower Control Limits
LF: Late Finish Date
LISS: Linearly Independent Spanning Set
LL: Lesson Learned
LLR: Lesson Learned Register
LOI: Letter Of Intent
LRE: Level of Rist Exposure
LS: Late Start Date
LSL: Lower Specification Limits
LTV: Long term Value

- M -
MAU: Monthly Active User
MBTI: Myers-Briggs Type Indicator
MBO: Management By Object
MCDM: Multi-Criteria Decision Making
MCSA: Monte-Carlo Simulation Approach
MECE: Mutually Exclusive, Collectively Exhaustive
MOA: Memorandum Of Agreement
MoM: Month over Month
MOU: Memorandum Of Understanding 
MRR: Monthly Recurring Revenue
MTBF: Mean Time Between Failure
MTTF:  Mean Time To Failure 
MTTR: Mean Time Between Repair

- N -
NC: Number of new Customer acquired
NDA: Non-Disclosure Agreement
NPS: Net Promoter Score
NPV: Net Present Value

- O - 
OBS: Organization Breakdown Structure
OPA:  Organizational Process Assets
OPM: Organizational Project Management
OPM3: Organizational Project Management Maturity Model
OTD: On Time Delivery

- P -
PBS: Product Breakdown Structure
PCDA: Plan-Do-Check-Act
PDF: Probability Density Function
PDM: Precedence Diagramming Method
PERT: Program Evaluation and Review Technique
PI: Probability , Impact
PLC: Product Life Cycle
PMB: Performance Measurement Baseline
PMI: Purchasing Manager Index
PMIS: Project Management Information System
PMO: Project Management Office
PO: Purchase Order
PO: Product Owner
POC: Proof of Concept
PP: Payback Period Method
PRA: Probabilistic Risk Analysis
PSND: Project Schedule Network Diagramming
PTA: Point of Total Assumption
PO: Purchase Order
POS: Point Of Sale
PP: 
ppb: parts per billion
PPm: parts per million
PQ: Pre-Qualificatoin
PV: Planned Value

- Q -
QA: Quality Assurance
QFD: Quality Function Development 
QoQ: Quarter on Quarter
QTD: Quarter To Date

- R -
R&R: Role and Responsibility
RACI: Responsible, Accountable, Consult, Inform
RAM: Responsibility Assignment Matrix
RBS: Resource Breakdown Structure
RCA: Root Cause Analysis
RFI: Request For Information
RFQ: Request For Quotation
RFP: Request For Proposal 
RICE: Reach, Impact, Confidence and Effort
ROI: Return On Investment
RSD: Relative Standard Deviation

- S -
SDLC: Software Development Life Cycle
SECI: Socializaton, Externalization, Combination, Inernaliztion
SIPOC: Supplier, Input, Process, Output, Customer
SLA: Service Level Agreements
SMART: Specific, Measurable, Attainable, Result oriented, Timely
SOW: Statement Of Work
SPC: Statistical Process Control
SPI: Schedule Performance Index
STEM: Science, Technology, Engineering, Mathematics(or Statistics)
STP: Segmentation, Targeting, and Positioning
SV: Schedule Variance
SWOT: Strength, Weakness, Opportunity, Threats

- T -
T&M: Time & Material
TBA: To Be Announced
TE: Total Expense
TF: Total Float
TQC: Total Quality Control 
TQM: Total Quality Management 

- U -
UCL: Upper Control Limits
USL: Upper Specification Limits

- V -
VAC: Variance At Completion
VD: Verified Deliverbles
VIE: Valence, Instrumentaliry, Expectation

- W -
WAU: Weekly Active User
WBS: Work Breakdown Sheet
WIP: Work In Progress

- X -
XP: eXtreme Programming

- Y -
YoY: Year on(over) Year
YTD: Year To Date

- Z -